W|W|W|W|W|W|W|W|W|W
W|G|G|G|G|G|G|G|G|W
W|G|G|G|G|G|G|G|G|W
W|G|G|G|G|G|G|G|G|W
W|G|G|G|G|G|G|G|G|G
W|G|G|G|G|G|G|G|G|W
W|G|G|G|G|G|G|G|G|W
W|W|W|W|W|W|W|W|W|W
M|Monster1|1|4|4|Up
P|10|5|2|1|5