W|W|W|W|W|W|W|W|W|W
W|G|G|G|G|G|G|G|G|W
W|G|G|G|G|G|G|G|G|W
W|G|G|G|G|G|G|G|G|W
W|G|G|G|G|G|G|G|G|G
W|G|G|G|G|G|G|G|G|W
W|G|G|G|G|G|G|G|G|W
W|W|W|W|W|W|W|W|W|W
M|2|1|3|10
P|10|5|2|1|5