W|W|W|W|W|W|W|W|W|W
W|G|G|G|G|G|G|G|G|W
W|G|G|G|G|G|G|G|G|W
W|G|G|G|G|G|G|G|G|W
G|G|G|G|G|G|G|G|G|W
W|G|G|G|G|G|G|G|G|W
W|G|G|G|G|G|G|G|G|W
W|W|W|W|W|W|W|W|W|W
M|3|1|7|7|Up
P|1|5|1|10|5